1,1,1,1,1,1,1,1,1,1,1,1,1,1,1
1,1,1,1,1,1,1,1,1,1,2,1,1,1,1
1,1,1,2,1,1,1,1,1,1,1,1,1,6,1
1,1,1,1,1,1,1,1,1,1,1,1,1,1,1
1,1,1,1,1,1,2,1,1,2,1,1,1,2,1
2,1,1,1,6,1,1,1,1,2,1,4,1,2,1
1,1,1,1,1,1,1,1,1,2,1,1,1,2,1
1,1,2,1,1,1,1,1,1,2,2,2,2,2,1
1,1,1,1,1,1,1,1,1,1,1,1,1,1,1
1,1,1,1,1,1,1,2,1,1,1,1,1,1,1
1,2,1,1,1,2,1,1,1,1,1,2,2,1,1
1,2,1,5,1,2,1,1,1,1,2,3,6,2,1
1,2,1,1,1,2,1,1,1,1,2,6,3,2,1
1,2,2,2,2,2,1,1,6,1,1,2,2,1,1
1,1,1,1,1,1,1,1,1,1,1,1,1,1,1