2,2,2,2,2,1,1,1,1,1,2,2,2,2,2
2,2,2,2,2,1,1,1,1,1,2,2,2,2,2
2,2,2,2,2,1,1,1,1,1,2,2,2,2,2
1,2,2,2,1,1,1,1,1,1,1,2,2,2,1
1,2,2,2,1,1,6,1,1,1,1,2,2,2,1
1,1,2,1,1,1,1,1,1,1,1,1,2,1,1
1,1,1,1,1,1,1,1,1,1,1,1,1,1,1
1,1,1,4,1,1,1,1,6,1,1,1,1,1,1
1,1,4,4,1,1,1,1,1,1,1,1,1,1,1
1,1,1,1,1,1,1,1,1,1,1,1,5,5,1
1,1,6,1,1,2,1,1,1,1,2,1,1,5,1
1,2,1,1,1,2,1,1,1,1,2,1,1,1,1
1,6,1,1,2,2,2,3,3,2,2,2,1,1,6
1,1,2,1,2,2,2,1,1,2,2,2,1,6,1
2,1,1,1,2,2,2,1,1,2,2,2,6,1,1