4,4,4,4,4,4,4,4,4,4,4,4,4,4,4
2,2,2,2,2,2,2,2,2,2,2,2,2,2,2
2,2,2,2,2,2,1,1,2,2,2,2,2,2,2
2,6,2,2,2,2,1,1,1,2,2,3,3,2,2
2,2,2,2,2,2,2,1,1,2,6,2,2,2,2
2,2,2,5,5,2,2,2,2,2,2,2,2,2,2
2,2,5,5,5,2,2,2,2,2,1,1,1,2,2
2,2,5,5,2,2,2,2,2,2,1,1,1,1,2
2,2,2,2,2,2,2,2,2,2,2,1,1,1,2
2,1,1,2,2,2,2,6,2,2,2,2,2,2,2
2,1,1,1,2,2,2,2,2,2,3,3,2,2,2
2,3,1,1,2,2,2,2,2,2,3,3,2,2,2
2,2,2,2,2,2,2,1,1,2,2,2,2,2,2
2,2,2,6,2,2,1,1,1,2,2,2,2,6,2
2,2,2,2,2,2,1,1,2,2,2,2,2,2,2