1,1,1,1,1,1,1,2,1,1,1,1,1,1,1
1,1,1,1,1,1,1,2,1,1,1,1,1,1,1
1,1,1,1,1,2,1,2,1,2,1,1,1,1,6
6,1,1,1,1,1,2,2,2,1,1,1,1,1,1
1,1,1,1,1,1,1,2,1,1,1,1,1,1,1
1,1,1,1,1,1,1,1,1,1,1,1,1,1,1
1,1,2,1,1,1,1,1,1,1,1,1,2,1,1
1,4,2,1,1,1,1,1,1,1,1,1,2,4,1
4,4,2,1,1,1,6,1,1,1,1,1,2,4,4
4,4,2,2,1,1,1,1,1,1,1,2,2,4,4
4,2,2,2,1,1,1,1,6,1,1,2,2,2,4
2,6,2,2,1,1,1,1,1,1,1,2,2,3,2
2,3,2,6,2,1,1,1,1,1,2,2,3,6,2
2,2,6,2,2,1,1,1,1,1,2,2,2,6,2
2,2,2,2,2,1,1,1,1,1,2,2,2,2,2