1,1,1,1,1,2,1,1,1,2,1,1,1,1,1
1,6,1,1,2,2,1,1,1,2,2,1,1,6,1
1,1,1,2,2,1,1,1,1,1,2,2,1,1,1
1,1,2,2,1,1,1,1,1,1,1,2,2,1,1
1,2,2,1,1,2,1,1,1,2,1,1,2,2,1
1,2,1,1,1,1,1,2,1,1,1,1,1,2,1
1,1,1,2,1,1,1,6,1,1,1,2,1,1,1
1,1,1,1,1,2,6,3,6,2,1,1,1,1,1
1,1,1,1,1,1,1,6,1,1,1,1,1,1,1
1,2,2,1,1,1,1,2,1,1,1,1,2,2,1
1,1,2,1,1,2,1,1,1,2,1,1,2,1,1
1,1,4,2,1,1,1,1,1,1,1,2,5,1,1
1,1,4,4,2,1,1,1,1,1,2,5,5,1,1
1,1,4,4,2,2,1,1,1,2,2,5,5,1,1
1,1,1,2,2,2,1,1,1,2,2,2,1,1,1